##########
#E####...#
##.....#.#
###.##.#.#
###.##..##
#.#.###.##
##...##.##
##.#.##.##
##......##
####.###.#
