......#.#E
##.##...#.
#.....#.#.
##.##.#.#.
##.##.###.
.......#..
..##.#.#..
..##.#.#..
..#..#.#..
....##....
