##########
#...##...#
#.#..#.#.#
#.#.##.#.#
#....#..##
##.#######
##......##
##.####.##
##...#..##
####E###.#
