##########
#........#
#........#
#........#
#........#
#........#
#........#
#..####..#
#........#
####E###.#
